########
#M     #
#      #
# XXX  #
#      #
#   XX #
#     $#
########
