########
#M     #
#B     #
#XXXX  #
#      #
#   XX #
#     $#
########
